11111111111111111111
10000000001100000001
10111011011011101101
10101010000010101001
10111011111111101101
10000000001100000001
10111011011011101101
10001000000001000001
10101111111111011101
10101111111111011101
10000000001100000001
10111011011011101101
10001000000001000001
11101111111111011111
10000000001100000001
10111011011011101101
10001000000000000001
10111101101111111101
10000000000000000001
11111111111111111111
