1111111111
1000100001
1010101101
1110001001
1000101111
1011100001
1010001101
1010101101
1000100001
1111111111